Lisada Wordnetti. Kujul mõiste - seletus(, näide):
käärlöök - löök, kus mängija lööb palli üle enda pea võimalikult madalale, kasutades selleks jalgadega kääridena vibutusest tulenevat hoogu
kübaratrikk - ühe mängija poolt kolm väravat ühes mängus
silm - punkt
noorteakadeemia - kooli taoline koht, kus ka õpetatakse noori, kuid põhirõhk on spordil
spordiakadeemia - noortakadeemia
mängujärgne - pärast mängu toimuv
ülevaade - mängujärgne analüüs/kokkuvõte
avapoolaeg - jalgpalli esimene poolaeg
kolmveerandtund - avapoolaeg
lõppskoor - lõpptulemus
omavärav - mängoja lööb tahtmatult endale värava
lõpuvile - mängu lõppu signaliseeriv vile
avavile - mängu algust signaliseeriv vile
tsoon - piirkond, kus kohalikud mängivad, nt. lõunatsoon
tööandja - ei ole tähendusega varem
võidupunkt - punkt, mille saab võitja, sõltuvalt alast on punktide arv erinev, nt. kolm võidupunkti läksid Tammekale
tabelirida - koht tabelis
sööt - palli veeretamine väljakut mööda kaasmängijale
meeskonnakaaslane - samas meeskonna mängija 
liigatabel - liiga meeskondade järjestuse tabel
koduväljak - väljak, kus mängib kodumeeskond
vigastuspaus - periood, kus mängija ei saa mängida vigastuse tõttu
karikafinaal - karikaturniiri finaalmäng
karikasari - karikavõistlus
esiliigameeskond - meeskond, kes mängib esiliigas
täiskäik - meeskond mängib nii kõvasti kui võimalik
külalismeeskond - meeskond, kes mängib võõrsil
sats - meeskond
eeltöö - töö, mis tehakse enne mingi asja saavutamist
kõrgliigameeskond - meskond, kes mängib kõrgliigas
üleminut - minutid, mis lisatakse põhiajale korvamaks põhiajal olnud katkestusi
väravakütt - ründaja
tipuründaja - ründaja
luhtama - võimalust raiskama, võimalust mitte realiseerima
väravasööt - sööt, mille järel söödu saanud mängija lööb värava
liigahooaeg - periood, mille jooksul kestab üks liiga aasta
hoolealune - treeneri hoole all olev võistkond/mängija
viigipunkt - viigi korral antav üks punkt
varuväravavaht - varumängija, kelle poolt mängitav positsioon on väravavaht
suurklubi - klubi, kes on tuntud ning on palju võitnud
linnarivaal - meeskonna rivaal, kes asub samas linnas
libastuma - punkte kaotama või platsil libisema
avavärav - mängu või meeskonna esimene värav
tabamus - värava löömine
auvärav - kaotusele vaatamata ühe värava saamine
eelring - mingi turniiri kvalifikatsiooni voor
konkurent - täpsustus, võib olla ka meeskond mitte üksikisik
liiderkolmik - turniiri esimesed kolm võistkonda
võõrsil - vastase kodustaadionil mängima
pooltund - pool tundi kestev periood mängus
liider - võistluse esimene
meeskonnakaaslane - mängijaga samas meeskonnas olev mängija
võiduvärav - värav, mis tagab võidu
võidumäng - mäng, mis võidetakse
leivaisa - tööandja
väravasuu - väravaesine
täismäng - terve mäng
eelviimane - turniiritabelis eelviimasel kohal olev võistkond
põhiturniir - turniiri osa mis mängitakse enne play-offe
avalöök - algus mängule või turniirile
koduklubi - klubi, mida mängija esindab
liidristaatus - meeskond juhib
väravavõrk - võrk, mis on kinnitatud väravaraamile
tabeliliider - turniiritabelit juhtiv meeskond/võistleja
rivistus - teine tähendus koosseis
jalgpalliklubi - jalgpallimeeskond
vigastama - teine tähendus, ennast vigastama
põlvevigastus - vigastus, mis on seotud põlvepiirkonnaga
MM - lühend maailmameistrivõistlustest
lähirivaal -  meeskond, mis on turniiritabelis lähedal
kapten - täpsustus, võib ka olla meeskonna liider sportmängus
mängupäev - päev kui toimub mäng
jalgpallikarikavõistlus - jalgpallivõistlus, kus võija saab karika
poolfinaalkohtumine - kohtumine, mille võitjad edenevad finaali
tabelijuht - tabeliliider
võõrustama - spordis koduväljakul/staadionil võistlema
poolajavile -  vile, mis märgib poolaja lõppu
üleaeg - üleminutid
punane kaart - kaart, mille tõttu peab mängija platsilt lahkuma, tavaliselt teise mängija tõsise vigastamise tõttu
turniiritabel - turniiri meeskondade paremusjärjestus
avamäng - esimene mäng
viigiseis - kui seis on viigiline
igirivaal  - meeskond, kes on ajalooliselt suur rivaal
vastasseis - mäng
mängima - sportmängu mängima
mäng - mingi spordiala kohtumine
esmaesinemine - esimest korda esinemine (üldiselt)
kodumäng - mäng, kus meeskond saab mängida koduväljakul
kodumatš - kodumäng
tabama - skoorima
skoorima - väravasse palli lööma
sukelduma - teesklema, et mängijale on tehtud viga
näitlema  - teesklema, et mängijale on tehtud viga
väljavise - mängija viskab auti sisse
puhastama - vastase rünnakut katkestama, lüües palli eemale
sekkuma - mängu tulema vahetusest või mingisse olukorda lisanduma
vastasmeeskond - meeskond, kelle vastu mängitakse
möödalöök - löök, mis läheb väravast mööda
tõrjuma - väravavaht tõrjub löögi
kannalöök - löök, mis tehakse kannaga
pealöök - löök, mis tehakse peaga
kõmmutama - lööma värava suunas
vint ka vintpall - löök, mis õhus muudab kaarjalt suunda
keerutama - lööma viisil, kus pall saab vindi sisse
katma - vastasmeekonna mängijat peale võtma, kaitsma
vaba - mängijat ei kaeta vastasmeeskonna mängijate poolt
vaheltlõige - vastasmängijate söötu poole pealt endale võtma
läbisööt - sööt, mis ei lähe täpselt kaasmängijale vaid ettepoole, et ta joostes selleni jõuaks
tagasisööt - sööt, mille suund on enda värava poole
tõstma - aeglase hooga õhust tulev tsenderdus
lugema - arvestama, kohtunik luges värava ära
sisse laskma - väravat sisse laskma
väravalööja - mängija, kes lõi värava
penaltilööja - mängija, kes lööb penaltit
duubel - 2 väravat
üle kombineerima - liiga palju kombinatsioone tegema, millest tuleneb ebaõnnestumine
vormistama - skoorima
üle jooksma  - kiiremini jooksma kui vastane, teda edestama
libistama - ennast maad mööda libistama, et kiiremini pallini jõuda
õhuvõitlus - mitu mängijat hüppavad õhtu, et pall peaga kätte saada
üks ühele - mänguolukord, kus mõlemast meeskonnast on palli läheduses vaid üks mängija ning üritatakse seda mängijat edestada
üleaste - trikk, kus mängija liigutab jala kiiresti üle palli, viidates sellele, et ta hakkaks sinna poole palliga liikuma, kuid siis teeb äkkilise liigutuse ing läheb hoopis teises suunas(ing k step over)
apelleerima - otsust vaidlustama
maha tõmbama - vastasmängijat maha kukutama, viga tegema
eemaldama - platsilt minema saatma punase kaardi tõttu
müür - mängijatest moodustatud sein, karistuslöögi ajal
kaistemüür - mängijatest moodustatud sein, karistuslöögi ajal
vedama - joostes palli endaga kaasas hoidma 
väravavahiala - värava ümber olev joontega märgitud piirkond suurusega  5.5 x 18.32 m, mille seest peab tegema lahtilööke
viiekast - väravavahiala
ära tooma/ära võtma - mängijat välja vahetama
vasturünnak - kui ühe meeskonna rünnak asendub teise meeskonna rünnakuga
kontrarünnak - vasturünnak
rüselus - kerge kaklus
kinnitama - kindlamaks tegema, nt eduseisu
tasavägine - võrdne
välja vilistama - vilistamise teel ebasoosingut näitama
võistlusfaas - mingi võistluse etapp
väljalangemine - turniiri reeglitest tulenev otsus, mis lõpetab võistkonna võimlause veel mänge pidada
vastu võtma - võõrustama
derbi - rivaalide kohtumine
korduskohtumine - teine kohtumine, kus sama meeskonnaga on juba samas võistlusfaasis mängitud
lisaaeg - viigilise tulemuse puhul võitja selgitamiseks mängitav aeg mõne turniiri puhul
edasipääs - edenemine järgmisesse ringi
alagrupifaas - turniiri faas, kus meeskonnad on jaotatud alagruppidesse ning kõik mängivad kõikidega läbi
puhkama võtma - välja vahetatud mängijad võetakse puhkama
putsa - jalgpallijalats
kedra - jalgpallisokk
kaptenipael - pael, mida kannab kapten ümber õlavarre
keskkaitsja - kaitsja, kelle positsioon asub keskel
ründaja, täpsustus
kaitsja, täpsustus
vasakkaitsja - kaitsja, kes kaitseb vasakul äärel
paremkaitsja - kaitsja, kes kaitseb paremal äärel
vasak poolkaitsja - poolkaitsja, kes mängib vasakul äärel
parem poolkaitsja - poolkaitsja, kes mängib paremal äärel
vasakäär - vasak poolkaitsja
paremäär - parem poolkaitsja
keskpoolkaitsja - poolkaitsja, kes mängib keskväljakul
põhimees - mängija kes põhikoosseisus või kes mängib suurt rolli meeskonna edus
reservmeeskond - klubi tugevuselt teine meeskond
duubelmeeskond - reservmeeskond
varumees - mängija, kes ei alusta põhikoosseisus
äärekaitsja - kaitsja, kes ei ole keskaitsja
ääremängija - mängija, kes mängib äärel
vastasmängija - vastasmeeskonna mängija
abikohtunik - äärekohtunik
otsakohtunik - kohtunik, kes on otsajoone taga ning kelle ülesanne on jälgida, kas pall ületas väravajoont
neljas kohtunik - kohtunik, kes vahetab välja teisi kohtunikke, kui need peaksid ennast vigastama, ning näitab lisaaega ja vahetab mängijaid
ründeliin - grupp, mille moodustavad ründajad
kaitseliin - grupp, mille moodustavad kaitsjad
poolkaitseliin  - grupp, mille moodustavad poolkaitsjad
keskväli - piirkond väljaku keskel, samas ka üldistavalt poolkaitsjate kohta
keskring - ringi kujuline joon keskväljal
nurgalipp - lipp, mis tähistab väljaku nurka
väravaala - väravavahiala
penaltipunkt - koht väljakul, kust lüüakse penalteid
küljeaut - kahe käe vahel üle pea palli väljakule sisseviskamine
latt - värava horisontaalne osa
põiklatt - posti ja lati ristumiskoht jalgpallis
küljevõrk - jalgpalliväraval postide taga olev võrk
väravaraam - väravakonstruktsioon, mille moodustavad postid ja latt
maha raputama - tegema midagi nii hästi, et vastane ei suuda järel püsida


Kahtluse all:
kaarti korjama - teenis kollase kaardi
hiline viga - viga mis on tehtud väravale lähedal
mööda mängima - vastasest mööduma
jooksu/hoo peale andma - söötma palli kaasmängijast ettepoole, et tal oleks võimalik kiiremini palliga teekonda jätkata
üles korjama - palli enda valdusesse võtma
külla sõitma - võõrale platsile mängima minema
enda ees nägema - nägi enda ees punast kaarti
tegi otsad - võitis suurelt
puhkust andma - mängijat välja vahetama või üldse mängule mitte kaasama, et puhkust anda
ära kindlustama - tagama võidu vms
tõrjetöö - väravavahi oma ülesannet tegemas
skoori avama - esimest väravat lööma
püsima jääma - mängija ei kukkunud maha või meeskond ei  kukkunud liigast välja
alla jääma - kaotama
koheselt vastama - hrl. kohe vastu värava lööma
tabloole tooma - skoorima
juppideks võtma - kõvasti võitma või vastase positsioone ning mängijaid segadusse ajama
kinni hoidma - mingit abstraksset olukorda säilitama, nt. eduseisust kinni hoidma
kollast kaarti teenima - kui kohtunik näitab mängijale kollast kaarti
kollast kaarti andma  - kui kohtunik annab mängijale kollase kaardi
võõras väljak - kui meeskond ei mängi koduväljakul
ette minema - värava löömise abil juhtima minema
täpne olema - skoorima
paremini alustama - paremini mängima kui vastasmeeskond mängu algfaasis
tuliseks minema - kui mäng on pingeline või agressiivne
läbi jala - skoorima kellegi poolt või väravavahi jalgade vahelt, nt. läbi James Murphy jala ühe tagasi lüüa
lukku panema - võitma või väga hästi kaitsma
võitjana väljuma - võitma mängu, mis võis olla tasavägine
mängu astuma - sekkuma
hoogu sattuma - hästi mängima, võib-olla ka palju väravaid lööma või tõrjuma
tabamuse eest hoolitsema - skoorima
jala valgeks saama - skoorima
samade punktide peal olema - viigis liigatabelis olema
värav ei sündinud - toimus pealelöök, mis tõrjuti vms
palli väravavahi selja taha suunama - skoorima
täpne olema - skoorima
positsiooni kindlustama - liigatabeli kohta kindlustama, hrl. võiduga
tiitlile lähemale jõudma - hrl. võitma, olles liigatabeli liider 
sammu tiitli suunas astuma - hrl. võitma, olles liigatabeli liider 
head hoogu leidma - edukas väravate löömises või lihtsalt läheb mäng hästi
väravat puhtana hoidma - saama tulemust, kus endale ei lastud ühtegi väravat lüüa 
väravat kaitsma - tegema kaitsetööd
väravateta viik - mäng, mis jääb 0:0
kuues olema jne - liigatabelis koht
pingile vahetama - mängijat platsilt välja vahetama
läbi mängima - vastasest mööduma
väravas seisma - väravavaht olema
vahetusest sekkuma - kui mängija vahetatakse sisse
ohtlik tsoon - väljakukkumistsoon
ohutu tsoon - kui liigatabelis ei ohtusta väljakukkumine 
väljakule jooksma - mängu minema, kas põhikoosseisus või vahetusest
pingil istuma - varumees olema
suurt sammu astuma - saama tulemuse, mis aitab kõvasti soovitud suunas liikumiseks, nt. astus suure sammu finaali suunad
konkurentsist langema - kaotama, mille tulemusel ei saa enam edasi võistelda turniiril